file,peers,entries,origin_sets,v4_pfxs,ignored_v4_pfxs,ignored_v4_pfxs_pct,final_v4_pfxs,v6_pfxs,ignored_v6_pfxs,ignored_v6_pfxs_pct,final_v6_pfxs
data/ris/rrc00/2025.05/bview.20250501.0000.gz,108,50588359,1179,1032568,5631,0.5453393868490986,1026937,230906,1954,0.8462317999532277,228952
data/ris/rrc01/2025.05/bview.20250501.0000.gz,138,41144289,947,1036139,8157,0.787249587169289,1027982,234719,1628,0.6935953203617943,233091
data/ris/rrc03/2025.05/bview.20250501.0000.gz,163,41262531,911,1030298,5058,0.4909259262854048,1025240,229900,1401,0.6093953892996955,228499
data/ris/rrc04/2025.05/bview.20250501.0000.gz,22,8741898,213,1006427,3052,0.3032510057858146,1003375,220110,1177,0.5347326336831584,218933
data/ris/rrc05/2025.05/bview.20250501.0000.gz,68,13648038,305,1011179,3452,0.341383671931478,1007727,221939,1229,0.55375576171831,220710
data/ris/rrc06/2025.05/bview.20250501.0000.gz,21,6127705,146,1008819,2909,0.28835697979518626,1005910,221453,4897,2.211304430285433,216556
data/ris/rrc07/2025.05/bview.20250501.0000.gz,39,10125596,224,1003720,3109,0.30974773841310327,1000611,221192,920,0.4159282433361062,220272
data/ris/rrc10/2025.05/bview.20250501.0000.gz,60,17317702,389,998546,3591,0.3596228916845093,994955,219631,1000,0.45530913213526325,218631
data/ris/rrc11/2025.05/bview.20250501.0000.gz,47,10306609,248,1007234,3981,0.39524082785132353,1003253,230232,5433,2.3597935994996355,224799
data/ris/rrc12/2025.05/bview.20250501.0000.gz,151,40571760,886,1041158,5888,0.5655241567562272,1035270,224408,1497,0.6670885173434102,222911
data/ris/rrc13/2025.05/bview.20250501.0000.gz,27,5224948,124,1007920,3004,0.29803952694658303,1004916,220291,795,0.36088628223576996,219496
data/ris/rrc14/2025.05/bview.20250501.0000.gz,26,7515216,177,1004488,3761,0.3744196048135966,1000727,222514,1277,0.5738964739297302,221237
data/ris/rrc15/2025.05/bview.20250501.0000.gz,61,21329482,523,1043850,4393,0.42084590697897206,1039457,234825,1275,0.5429575215586074,233550
data/ris/rrc16/2025.05/bview.20250501.0000.gz,29,3957049,86,978495,1665,0.17015927521346558,976830,216117,736,0.34055627275966255,215381
data/ris/rrc18/2025.05/bview.20250501.0000.gz,25,1204839,32,981421,116,0.011819596279272605,981305,207988,4,0.0019231878762236284,207984
data/ris/rrc19/2025.05/bview.20250501.0000.gz,68,12750040,288,1002545,4029,0.40187722246881685,998516,232837,1173,0.5037859103149414,231664
data/ris/rrc20/2025.05/bview.20250501.0000.gz,66,28816218,639,1013774,3851,0.3798677022689475,1009923,226263,1272,0.5621776428315721,224991
data/ris/rrc21/2025.05/bview.20250501.0000.gz,74,27079809,618,1017924,3915,0.3846063163851132,1014009,223467,1073,0.4801603816223425,222394
data/ris/rrc22/2025.05/bview.20250501.0000.gz,31,4222362,69,1003727,1390,0.1384838706142208,1002337,215801,621,0.2877651169364368,215180
data/ris/rrc23/2025.05/bview.20250501.0000.gz,60,10131693,230,1020030,3644,0.35724439477270276,1016386,224002,995,0.44419246256729844,223007
data/ris/rrc24/2025.05/bview.20250501.0000.gz,35,15085306,382,1027049,3872,0.3770024604473594,1023177,229613,5674,2.471114440384473,223939
data/ris/rrc25/2025.05/bview.20250501.0000.gz,123,55529097,1348,1094633,5600,0.5115869885157857,1089033,245142,6255,2.5515823481900286,238887
data/ris/rrc26/2025.05/bview.20250501.0000.gz,30,3575826,91,997367,2972,0.2979845934345131,994395,229074,498,0.2173969983498782,228576
data/routeviews/amsix.ams/2025.05/rib.20250501.0000.bz2,77,27222939,634,1017396,4830,0.4747413986294422,1012566,226536,1325,0.5848959988699368,225211
data/routeviews/cix.atl/2025.05/rib.20250501.0000.bz2,20,1467426,33,971194,96,0.00988473981511418,971098,207578,165,0.07948819239033038,207413
data/routeviews/interlan.otp/2025.05/rib.20250501.0000.bz2,9,2012267,32,993219,292,0.02939935704008884,992927,211374,115,0.05440593450471676,211259
data/routeviews/iraq-ixp.bgw/2025.05/rib.20250501.0000.bz2,8,685,0,230,0,0.0,230,59,0,0.0,59
data/routeviews/kinx.icn/2025.05/rib.20250501.0000.bz2,19,34199,0,15929,2,0.012555715989704314,15927,2086,0,0.0,2086
data/routeviews/namex.fco/2025.05/rib.20250501.0000.bz2,31,4848709,108,999378,2318,0.2319442693355267,997060,215123,741,0.34445410300153867,214382
data/routeviews/pacwave.lax/2025.05/rib.20250501.0000.bz2,6,115516,6,19469,0,0.0,19469,38257,0,0.0,38257
data/routeviews/pit.scl/2025.05/rib.20250501.0000.bz2,28,1990978,37,973499,414,0.04252700824551438,973085,209158,534,0.2553093833369988,208624
data/routeviews/pitmx.qro/2025.05/rib.20250501.0000.bz2,20,1466298,40,1006647,4,0.00039735875634656437,1006643,218436,677,0.30993059752055524,217759
data/routeviews/route-views.amsix/2025.05/rib.20250501.0000.bz2,88,23194273,512,1029805,4490,0.4360048747092896,1025315,228271,1369,0.5997257645517827,226902
data/routeviews/route-views.bdix/2025.05/rib.20250501.0000.bz2,4,14522,0,6759,0,0.0,6759,723,0,0.0,723
data/routeviews/route-views.bknix/2025.05/rib.20250501.0000.bz2,27,1812131,34,983991,258,0.02621975200992692,983733,219513,582,0.2651323611813423,218931
data/routeviews/route-views.chicago/2025.05/rib.20250501.0000.bz2,61,18303671,426,1008122,3850,0.3818982226357524,1004272,223091,1296,0.5809288586271969,221795
data/routeviews/route-views.chile/2025.05/rib.20250501.0000.bz2,4,2398440,68,990052,1057,0.10676206906303912,988995,214722,171,0.0796378573224914,214551
data/routeviews/route-views.eqix/2025.05/rib.20250501.0000.bz2,74,25080331,576,1029736,4645,0.4510864920717543,1025091,232741,1314,0.564576073833145,231427
data/routeviews/route-views.flix/2025.05/rib.20250501.0000.bz2,60,10299442,227,1009294,3705,0.3670882815116309,1005589,223399,1117,0.5000022381478879,222282
data/routeviews/route-views.fortaleza/2025.05/rib.20250501.0000.bz2,41,9131369,216,1018481,3134,0.3077131532154257,1015347,226166,839,0.37096645826516805,225327
data/routeviews/route-views.gixa/2025.05/rib.20250501.0000.bz2,5,2227,0,1230,0,0.0,1230,0,0,0,0
data/routeviews/route-views.gorex/2025.05/rib.20250501.0000.bz2,20,330735,0,103633,1,0.0009649435990466358,103632,64270,0,0.0,64270
data/routeviews/route-views.isc/2025.05/rib.20250501.0000.bz2,29,7208616,168,1007904,4011,0.3979545671016287,1003893,221656,789,0.3559569783809146,220867
data/routeviews/route-views.kixp/2025.05/rib.20250501.0000.bz2,34,5378257,120,999288,2913,0.29150755337800516,996375,218892,782,0.3572538055296676,218110
data/routeviews/route-views.linx/2025.05/rib.20250501.0000.bz2,93,35899337,827,1034711,4973,0.48061729313789064,1029738,227988,1412,0.619330841974139,226576
data/routeviews/route-views.mwix/2025.05/rib.20250501.0000.bz2,10,287262,0,94383,1,0.001059512835998008,94382,51751,0,0.0,51751
data/routeviews/route-views.napafrica/2025.05/rib.20250501.0000.bz2,90,22465161,545,1060826,4280,0.4034591912340007,1056546,231133,5573,2.4111658655406196,225560
data/routeviews/route-views.nwax/2025.05/rib.20250501.0000.bz2,17,1008642,22,997052,1,0.0001002956716399947,997051,1248,0,0.0,1248
data/routeviews/route-views.ny/2025.05/rib.20250501.0000.bz2,28,7682837,169,1015892,3840,0.3779929362570037,1012052,221611,723,0.3262473433177956,220888
data/routeviews/route-views.perth/2025.05/rib.20250501.0000.bz2,68,7410314,135,984988,1310,0.13299654412033446,983678,219073,712,0.3250058199778156,218361
data/routeviews/route-views.peru/2025.05/rib.20250501.0000.bz2,8,6102,0,5307,0,0.0,5307,274,0,0.0,274
data/routeviews/route-views.phoix/2025.05/rib.20250501.0000.bz2,11,2217081,63,1007332,1030,0.10225030079457419,1006302,222795,529,0.23743800354586053,222266
data/routeviews/route-views.rio/2025.05/rib.20250501.0000.bz2,46,11919063,276,1017481,3403,0.3344534197690178,1014078,218652,1038,0.47472696339388615,217614
data/routeviews/route-views.sfmix/2025.05/rib.20250501.0000.bz2,30,5142395,110,1005254,2896,0.28808639408547493,1002358,221016,594,0.26875882289065045,220422
data/routeviews/route-views.sg/2025.05/rib.20250501.0000.bz2,106,22526019,564,1037952,4758,0.4584027007029227,1033194,231104,1254,0.5426128496261423,229850
data/routeviews/route-views.soxrs/2025.05/rib.20250501.0000.bz2,14,1783880,29,971247,97,0.009987160835503224,971150,207264,40,0.01929905820595955,207224
data/routeviews/route-views.sydney/2025.05/rib.20250501.0000.bz2,50,16096224,361,1014503,4154,0.4094615787237692,1010349,225863,936,0.4144105054834125,224927
data/routeviews/route-views.telxatl/2025.05/rib.20250501.0000.bz2,31,7307052,168,1001592,3512,0.350641778288964,998080,221547,1156,0.52178544507486,220391
data/routeviews/route-views.uaeix/2025.05/rib.20250501.0000.bz2,36,5227986,116,1021366,2744,0.2686598144054139,1018622,227141,612,0.2694361652013507,226529
data/routeviews/route-views.wide/2025.05/rib.20250501.0000.bz2,9,3596190,86,1004175,1444,0.14379963651753927,1002731,224478,4547,2.0255882536373275,219931
data/routeviews/route-views2.saopaulo/2025.05/rib.20250501.0000.bz2,71,16569797,365,1012631,3340,0.32983386840813683,1009291,223550,962,0.4303287855065981,222588
data/routeviews/route-views2/2025.05/rib.20250501.0000.bz2,26,21166533,486,1032446,4836,0.4684022215205444,1027610,0,0,0,0
data/routeviews/route-views3/2025.05/rib.20250501.0000.bz2,39,24789464,579,1027405,5231,0.5091468310938725,1022174,228609,1460,0.6386450227243896,227149
data/routeviews/route-views4/2025.05/rib.20250501.0000.bz2,39,22675877,558,1036025,4879,0.47093458169445723,1031146,234420,1490,0.6356112959645082,232930
data/routeviews/route-views5/2025.05/rib.20250501.0000.bz2,42,22620728,530,1054692,4542,0.43064705146146937,1050150,228738,1345,0.5880089884496673,227393
data/routeviews/route-views6/2025.05/rib.20250501.0000.bz2,25,4888463,120,0,0,0,0,229942,5505,2.3940819858920945,224437
data/routeviews/route-views7/2025.05/rib.20250501.0000.bz2,53,28296479,676,1038630,4513,0.43451469724540986,1034117,233218,1895,0.8125444862746443,231323
data/routeviews/route-views8/2025.05/rib.20250501.0000.bz2,6,3453652,89,1002730,2236,0.22299123393136736,1000494,226188,808,0.3572249633048614,225380
