file,peers,entries,origin_sets,v4_pfxs,ignored_v4_pfxs,ignored_v4_pfxs_pct,final_v4_pfxs,v6_pfxs,ignored_v6_pfxs,ignored_v6_pfxs_pct,final_v6_pfxs
data/ris/rrc00/2025.09/bview.20250901.0000.gz,110,54384869,1173,1056021,6245,0.5913708155424939,1049776,239334,1639,0.6848170339358386,237695
data/ris/rrc01/2025.09/bview.20250901.0000.gz,145,42732532,908,1038059,5279,0.5085452753648878,1032780,238904,1489,0.6232629005793122,237415
data/ris/rrc03/2025.09/bview.20250901.0000.gz,158,39815909,819,1045339,5263,0.503473036019894,1040076,238254,1525,0.6400731991907797,236729
data/ris/rrc04/2025.09/bview.20250901.0000.gz,21,8923351,208,1021752,3120,0.30535785591807013,1018632,230139,1185,0.5149062088563868,228954
data/ris/rrc05/2025.09/bview.20250901.0000.gz,68,13959707,287,1019459,3234,0.3172270782836779,1016225,228100,1165,0.5107409031126698,226935
data/ris/rrc06/2025.09/bview.20250901.0000.gz,22,6255574,139,1023538,3008,0.29388259155986396,1020530,231797,5030,2.170002200201038,226767
data/ris/rrc07/2025.09/bview.20250901.0000.gz,39,10345646,210,1023829,3931,0.38395083553991927,1019898,234080,1269,0.5421223513328777,232811
data/ris/rrc10/2025.09/bview.20250901.0000.gz,58,17740149,359,1016136,4056,0.39915916767046933,1012080,229739,1210,0.5266846290790853,228529
data/ris/rrc11/2025.09/bview.20250901.0000.gz,46,10533254,228,1023607,4312,0.42125542322395215,1019295,238997,5468,2.2878948271317214,233529
data/ris/rrc12/2025.09/bview.20250901.0000.gz,152,43134144,880,1050768,6348,0.6041295509570144,1044420,236554,1534,0.6484777260160471,235020
data/ris/rrc13/2025.09/bview.20250901.0000.gz,28,6335984,138,1019021,3051,0.29940501716843915,1015970,230199,855,0.37141777331786846,229344
data/ris/rrc14/2025.09/bview.20250901.0000.gz,25,6449571,139,1016637,3534,0.3476167009463555,1013103,228638,1259,0.5506521225693016,227379
data/ris/rrc15/2025.09/bview.20250901.0000.gz,59,18591969,408,1057792,4768,0.4507502420135528,1053024,241358,1388,0.5750793427191143,239970
data/ris/rrc16/2025.09/bview.20250901.0000.gz,29,4050016,78,995633,1942,0.19505179117204832,993691,224996,958,0.425785347295063,224038
data/ris/rrc18/2025.09/bview.20250901.0000.gz,24,1228936,25,997967,133,0.013327093982065538,997834,214759,7,0.003259467589251207,214752
data/ris/rrc19/2025.09/bview.20250901.0000.gz,69,12935369,254,1011196,4369,0.43206262683001123,1006827,234198,1212,0.5175108241744165,232986
data/ris/rrc20/2025.09/bview.20250901.0000.gz,68,30655444,597,1023743,4334,0.423348438035718,1019409,242122,1336,0.55178794161621,240786
data/ris/rrc21/2025.09/bview.20250901.0000.gz,77,29067948,599,1036350,3583,0.3457326192888503,1032767,236383,1315,0.5563005799909468,235068
data/ris/rrc22/2025.09/bview.20250901.0000.gz,31,4171739,566,1020478,2435,0.23861366928047445,1018043,226169,826,0.3652136234408783,225343
data/ris/rrc23/2025.09/bview.20250901.0000.gz,61,10185239,224,1037313,4131,0.3982404539420599,1033182,237020,993,0.4189519871740781,236027
data/ris/rrc24/2025.09/bview.20250901.0000.gz,33,13463067,292,1036247,4306,0.415537994319887,1031941,241590,5780,2.392483132579991,235810
data/ris/rrc25/2025.09/bview.20250901.0000.gz,119,56055804,1255,1144099,11743,1.0263971911521643,1132356,254852,5996,2.352738059736631,248856
data/ris/rrc26/2025.09/bview.20250901.0000.gz,30,3651765,88,1012772,2771,0.27360551042090425,1010001,235813,645,0.2735218160152324,235168
data/routeviews/amsix.ams/2025.09/rib.20250901.0000.bz2,76,26409338,472,1032331,5293,0.5127231479050808,1027038,232630,1442,0.6198684606456605,231188
data/routeviews/cix.atl/2025.09/rib.20250901.0000.bz2,18,1559965,22,1021498,25,0.0024473860937564247,1021473,228006,22,0.00964886888941519,227984
data/routeviews/decix.jhb/2025.09/rib.20250901.0000.bz2,48,3072952,46,1002085,1470,0.14669414271244455,1000615,231153,225,0.0973381266953057,230928
data/routeviews/getafix.mnl/2025.09/rib.20250901.0000.bz2,11,64186,0,8325,0,0.0,8325,46653,0,0.0,46653
data/routeviews/interlan.otp/2025.09/rib.20250901.0000.bz2,11,2033053,26,1010405,318,0.0314725283425953,1010087,219584,97,0.04417443893908482,219487
data/routeviews/iraq-ixp.bgw/2025.09/rib.20250901.0000.bz2,8,749,0,280,1,0.35714285714285715,279,62,0,0.0,62
data/routeviews/ix-br2.gru/2025.09/rib.20250901.0000.bz2,71,18360668,316,1029475,3435,0.3336652177080551,1026040,238337,1146,0.4808317634274158,237191
data/routeviews/kinx.icn/2025.09/rib.20250901.0000.bz2,19,58037,0,28319,1,0.0035311981355273846,28318,5727,0,0.0,5727
data/routeviews/namex.fco/2025.09/rib.20250901.0000.bz2,35,6992319,125,1024764,3488,0.34037105128595463,1021276,225788,860,0.3808882668698071,224928
data/routeviews/pacwave.lax/2025.09/rib.20250901.0000.bz2,10,152098,10,32970,1,0.0030330603579011226,32969,30420,2,0.006574621959237343,30418
data/routeviews/pit.scl/2025.09/rib.20250901.0000.bz2,28,2039868,26,988609,317,0.03206525532338872,988292,214211,476,0.22221081083604483,213735
data/routeviews/pitmx.qro/2025.09/rib.20250901.0000.bz2,20,1891032,29,1022971,8,0.0007820358543888341,1022963,232435,705,0.3033106029642696,231730
data/routeviews/route-views.amsix/2025.09/rib.20250901.0000.bz2,80,22186114,372,1046361,4611,0.44067009378216504,1041750,235908,1431,0.6065924004272852,234477
data/routeviews/route-views.bdix/2025.09/rib.20250901.0000.bz2,4,17123,1,6878,0,0.0,6878,2022,0,0.0,2022
data/routeviews/route-views.bknix/2025.09/rib.20250901.0000.bz2,27,874609,7,152805,14,0.009162003861130199,152791,229961,516,0.2243858741264823,229445
data/routeviews/route-views.chicago/2025.09/rib.20250901.0000.bz2,56,16260144,310,1021730,4160,0.40715257455492154,1017570,235005,1132,0.48169187889619375,233873
data/routeviews/route-views.chile/2025.09/rib.20250901.0000.bz2,4,2435021,48,1003242,1300,0.12957990195785263,1001942,222181,365,0.1642804740279322,221816
data/routeviews/route-views.eqix/2025.09/rib.20250901.0000.bz2,70,25524918,462,1054944,6785,0.6431621014954347,1048159,239398,1471,0.6144579319793816,237927
data/routeviews/route-views.flix/2025.09/rib.20250901.0000.bz2,59,12684738,211,1030594,4470,0.4337304505945115,1026124,238237,5358,2.2490209329365296,232879
data/routeviews/route-views.fortaleza/2025.09/rib.20250901.0000.bz2,43,10235604,187,1030524,3453,0.3350722545035341,1027071,236514,5294,2.2383452987983796,231220
data/routeviews/route-views.gixa/2025.09/rib.20250901.0000.bz2,5,2237,0,1229,0,0.0,1229,0,0,0,0
data/routeviews/route-views.gorex/2025.09/rib.20250901.0000.bz2,20,339406,0,103129,0,0.0,103129,69434,0,0.0,69434
data/routeviews/route-views.isc/2025.09/rib.20250901.0000.bz2,29,7337834,127,1021464,4495,0.4400546666353391,1016969,231052,907,0.3925523258833509,230145
data/routeviews/route-views.kixp/2025.09/rib.20250901.0000.bz2,31,5130154,86,1014923,3530,0.3478096367901801,1011393,228865,713,0.31153736919144476,228152
data/routeviews/route-views.linx/2025.09/rib.20250901.0000.bz2,94,37592148,668,1050152,6011,0.5723933297275061,1044141,234535,1513,0.6451062741168695,233022
data/routeviews/route-views.mwix/2025.09/rib.20250901.0000.bz2,10,298740,0,94384,0,0.0,94384,57855,0,0.0,57855
data/routeviews/route-views.napafrica/2025.09/rib.20250901.0000.bz2,91,23077852,425,1029988,4744,0.4605878903443535,1025244,236020,5439,2.304465723243793,230581
data/routeviews/route-views.nwax/2025.09/rib.20250901.0000.bz2,20,1218000,16,1012167,1,9.879792563875329e-05,1012166,1926,0,0.0,1926
data/routeviews/route-views.ny/2025.09/rib.20250901.0000.bz2,26,6654196,114,1031759,3966,0.3843920915640183,1027793,230596,653,0.28317923988273863,229943
data/routeviews/route-views.perth/2025.09/rib.20250901.0000.bz2,69,8142120,120,996753,2159,0.21660331095065677,994594,229165,875,0.38182095869788146,228290
data/routeviews/route-views.phoix/2025.09/rib.20250901.0000.bz2,11,2284581,57,1019315,1541,0.1511799590901733,1017774,226682,127,0.05602562179617261,226555
data/routeviews/route-views.rio/2025.09/rib.20250901.0000.bz2,50,12770392,224,1030867,4142,0.401797710082872,1026725,236898,1362,0.5749309829546894,235536
data/routeviews/route-views.sfmix/2025.09/rib.20250901.0000.bz2,30,6508717,108,1028391,3046,0.2961908456997387,1025345,230923,793,0.34340451146053014,230130
data/routeviews/route-views.sg/2025.09/rib.20250901.0000.bz2,98,22724779,444,1055290,5058,0.4792995290394109,1050232,242082,1285,0.5308118736626433,240797
data/routeviews/route-views.soxrs/2025.09/rib.20250901.0000.bz2,12,606708,2,226580,2,0.0008826904404625297,226578,76647,0,0.0,76647
data/routeviews/route-views.sydney/2025.09/rib.20250901.0000.bz2,50,15339525,273,1025247,4590,0.4476969939926671,1020657,231913,916,0.3949757020951823,230997
data/routeviews/route-views.telxatl/2025.09/rib.20250901.0000.bz2,34,7470622,131,1016574,4068,0.40016762183569515,1012506,231164,1176,0.5087297330034088,229988
data/routeviews/route-views.uaeix/2025.09/rib.20250901.0000.bz2,37,5347365,90,1034244,3110,0.3007027355246924,1031134,236299,793,0.3355917714421136,235506
data/routeviews/route-views.wide/2025.09/rib.20250901.0000.bz2,10,3660708,71,1018488,1533,0.1505172373164927,1016955,228070,4557,1.9980707677467444,223513
data/routeviews/route-views3/2025.09/rib.20250901.0000.bz2,37,24834702,460,1045204,5696,0.5449653847478578,1039508,234596,1481,0.6312980613480196,233115
data/routeviews/route-views4/2025.09/rib.20250901.0000.bz2,40,24140680,463,1053904,5945,0.564093124231429,1047959,245254,1418,0.5781760949872378,243836
data/routeviews/route-views5/2025.09/rib.20250901.0000.bz2,43,23726614,442,1068570,5124,0.4795193576462,1063446,242890,1415,0.5825682407674256,241475
data/routeviews/route-views6/2025.09/rib.20250901.0000.bz2,25,5069936,87,0,0,0,0,236332,5527,2.338659174381802,230805
data/routeviews/route-views7/2025.09/rib.20250901.0000.bz2,49,26029576,484,1052081,5094,0.4841832520499847,1046987,239495,1960,0.8183886928745903,237535
data/routeviews/route-views8/2025.09/rib.20250901.0000.bz2,20,8371547,180,1035452,6026,0.5819680680514403,1029426,241490,1611,0.667108368876558,239879
