file,peers,entries,origin_sets,v4_pfxs,ignored_v4_pfxs,ignored_v4_pfxs_pct,final_v4_pfxs,v6_pfxs,ignored_v6_pfxs,ignored_v6_pfxs_pct,final_v6_pfxs
data/ris/rrc00/2025.04/bview.20250401.0000.gz,107,50305308,1144,1033716,5575,0.5393164079882675,1028141,231610,1892,0.816890462415267,229718
data/ris/rrc01/2025.04/bview.20250401.0000.gz,137,40784174,906,1025908,8125,0.7919813472553096,1017783,228521,1635,0.7154703506461113,226886
data/ris/rrc03/2025.04/bview.20250401.0000.gz,161,39833370,856,1027113,5093,0.4958558600660298,1022020,229519,1397,0.6086642064491393,228122
data/ris/rrc04/2025.04/bview.20250401.0000.gz,22,8713335,211,1003709,2963,0.29520508434217485,1000746,218229,1173,0.5375087637298435,217056
data/ris/rrc05/2025.04/bview.20250401.0000.gz,68,13594259,292,1002075,3335,0.33280942045256096,998740,216357,1225,0.5661938370378587,215132
data/ris/rrc06/2025.04/bview.20250401.0000.gz,21,6109013,145,1005656,3111,0.30935031462050644,1002545,219950,4913,2.233689474880655,215037
data/ris/rrc07/2025.04/bview.20250401.0000.gz,37,9861455,211,999574,2941,0.2942253399948378,996633,219446,1028,0.4684523755274646,218418
data/ris/rrc10/2025.04/bview.20250401.0000.gz,60,17260991,375,994269,3411,0.3430661118872257,990858,217941,991,0.4547102197383695,216950
data/ris/rrc11/2025.04/bview.20250401.0000.gz,47,10267349,241,1005279,3907,0.38864832548973965,1001372,228165,5425,2.377665286086823,222740
data/ris/rrc12/2025.04/bview.20250401.0000.gz,154,41923629,888,1032181,5841,0.5658891221597763,1026340,222568,1461,0.6564285971029079,221107
data/ris/rrc13/2025.04/bview.20250401.0000.gz,27,5231361,120,1031106,2765,0.2681586568209282,1028341,218512,771,0.35284103390202826,217741
data/ris/rrc14/2025.04/bview.20250401.0000.gz,26,7492481,170,1002929,3685,0.3674238156439788,999244,220330,1263,0.5732310624971634,219067
data/ris/rrc15/2025.04/bview.20250401.0000.gz,58,19253986,465,1043139,4223,0.4048357889025336,1038916,232497,1279,0.5501146251349479,231218
data/ris/rrc16/2025.04/bview.20250401.0000.gz,29,3944315,82,975783,1612,0.16520066449200282,974171,214233,726,0.3388833653078657,213507
data/ris/rrc18/2025.04/bview.20250401.0000.gz,23,1200257,31,978626,120,0.012262089909730581,978506,206352,0,0.0,206352
data/ris/rrc19/2025.04/bview.20250401.0000.gz,66,12641400,281,993587,3904,0.3929197946430459,989683,226570,1189,0.5247826278854217,225381
data/ris/rrc20/2025.04/bview.20250401.0000.gz,66,28743209,612,1004193,3809,0.37930955503573516,1000384,220740,1252,0.5671831113527226,219488
data/ris/rrc21/2025.04/bview.20250401.0000.gz,77,28172099,628,1015297,3856,0.3797903470610077,1011441,221694,1269,0.5724106200438442,220425
data/ris/rrc22/2025.04/bview.20250401.0000.gz,31,4223947,65,1001909,1942,0.19382997857090814,999967,213876,819,0.38293216630196936,213057
data/ris/rrc23/2025.04/bview.20250401.0000.gz,58,10087089,217,1016616,3491,0.3433941625943326,1013125,222175,971,0.43704287161021715,221204
data/ris/rrc24/2025.04/bview.20250401.0000.gz,35,15139082,366,1032630,3598,0.3484307060612223,1029032,224584,5406,2.4071171588358924,219178
data/ris/rrc25/2025.04/bview.20250401.0000.gz,126,56900292,1345,1079086,5611,0.5199770917239219,1073475,242694,5934,2.4450542658656578,236760
data/ris/rrc26/2025.04/bview.20250401.0000.gz,30,3572414,91,993862,2868,0.2885712503345535,990994,227156,491,0.21615101516138688,226665
data/routeviews/amsix.ams/2025.04/rib.20250401.0000.bz2,77,25953525,582,1014549,4825,0.475580775300158,1009724,224316,1336,0.5955883664116692,222980
data/routeviews/cix.atl/2025.04/rib.20250401.0000.bz2,20,1465243,31,969349,106,0.010935174018851827,969243,205943,162,0.07866254254818081,205781
data/routeviews/interlan.otp/2025.04/rib.20250401.0000.bz2,4,273997,0,111443,0,0.0,111443,25566,0,0.0,25566
data/routeviews/iraq-ixp.bgw/2025.04/rib.20250401.0000.bz2,8,690,0,230,0,0.0,230,59,0,0.0,59
data/routeviews/kinx.icn/2025.04/rib.20250401.0000.bz2,19,37578,0,19269,1,0.005189682910374176,19268,2237,0,0.0,2237
data/routeviews/namex.fco/2025.04/rib.20250401.0000.bz2,31,4832994,104,996657,2171,0.21782819967150185,994486,213273,738,0.34603536312613414,212535
data/routeviews/pacwave.lax/2025.04/rib.20250401.0000.bz2,8,165105,10,32308,6,0.01857125170236474,32302,37974,0,0.0,37974
data/routeviews/pit.scl/2025.04/rib.20250401.0000.bz2,28,1997372,35,971028,442,0.04551876979860519,970586,210024,527,0.25092370395764296,209497
data/routeviews/pitmx.qro/2025.04/rib.20250401.0000.bz2,20,1471638,36,1012683,4,0.0003949903375488677,1012679,218574,879,0.4021521315435505,217695
data/routeviews/route-views.amsix/2025.04/rib.20250401.0000.bz2,89,23323204,499,1027175,4638,0.45152968092097256,1022537,222339,1372,0.6170757267056162,220967
data/routeviews/route-views.bdix/2025.04/rib.20250401.0000.bz2,4,14474,0,6716,0,0.0,6716,704,0,0.0,704
data/routeviews/route-views.bknix/2025.04/rib.20250401.0000.bz2,27,617427,4,139837,36,0.025744259387715695,139801,209786,110,0.05243438551666937,209676
data/routeviews/route-views.chicago/2025.04/rib.20250401.0000.bz2,64,18255691,412,1006492,3857,0.3832121864853372,1002635,224317,1307,0.5826575783377987,223010
data/routeviews/route-views.chile/2025.04/rib.20250401.0000.bz2,4,2389926,67,987539,653,0.06612397080014056,986886,213094,342,0.16049255258242842,212752
data/routeviews/route-views.eqix/2025.04/rib.20250401.0000.bz2,72,24989787,560,1020383,4654,0.4561032475060835,1015729,230200,1340,0.5821025195482189,228860
data/routeviews/route-views.flix/2025.04/rib.20250401.0000.bz2,64,11466523,243,1001614,3632,0.36261473980994674,997982,220796,1060,0.4800811608905958,219736
data/routeviews/route-views.fortaleza/2025.04/rib.20250401.0000.bz2,39,7912978,170,1022110,3008,0.2942931778380018,1019102,222759,865,0.38831203228601313,221894
data/routeviews/route-views.gixa/2025.04/rib.20250401.0000.bz2,5,7990,0,6935,0,0.0,6935,0,0,0,0
data/routeviews/route-views.gorex/2025.04/rib.20250401.0000.bz2,20,332853,0,104061,1,0.0009609748128501552,104060,64934,0,0.0,64934
data/routeviews/route-views.isc/2025.04/rib.20250401.0000.bz2,29,7199983,163,1006256,4011,0.39860631886915454,1002245,222987,774,0.3471054366398041,222213
data/routeviews/route-views.kixp/2025.04/rib.20250401.0000.bz2,32,5357669,116,996688,2880,0.2889570256690158,993808,217113,759,0.34958754197123154,216354
data/routeviews/route-views.linx/2025.04/rib.20250401.0000.bz2,94,35543496,803,1032019,5079,0.4921421020349432,1026940,226075,1414,0.6254561539312176,224661
data/routeviews/route-views.mwix/2025.04/rib.20250401.0000.bz2,10,293444,0,95846,1,0.0010433403584917472,95845,53324,0,0.0,53324
data/routeviews/route-views.napafrica/2025.04/rib.20250401.0000.bz2,90,22391949,533,1055838,4341,0.4111426184698789,1051497,228978,5521,2.411148669304475,223457
data/routeviews/route-views.nwax/2025.04/rib.20250401.0000.bz2,17,1005741,22,994393,1,0.00010056386157183327,994392,1224,0,0.0,1224
data/routeviews/route-views.ny/2025.04/rib.20250401.0000.bz2,28,7653787,166,1013095,3567,0.35208938944521495,1009528,222870,721,0.323506977161574,222149
data/routeviews/route-views.perth/2025.04/rib.20250401.0000.bz2,78,12274032,253,983991,1898,0.1928879430807802,982093,217853,876,0.4021060072617775,216977
data/routeviews/route-views.peru/2025.04/rib.20250401.0000.bz2,8,5927,0,5168,0,0.0,5168,262,0,0.0,262
data/routeviews/route-views.phoix/2025.04/rib.20250401.0000.bz2,10,1960209,61,1003956,862,0.0858603365087713,1003094,219753,387,0.17610681082852112,219366
data/routeviews/route-views.rio/2025.04/rib.20250401.0000.bz2,46,12068526,270,1024282,3268,0.31905276086077855,1021014,219977,1063,0.4832323379262377,218914
data/routeviews/route-views.sfmix/2025.04/rib.20250401.0000.bz2,32,6303631,138,1002504,2928,0.29206866007517174,999576,222413,880,0.39566032561046344,221533
data/routeviews/route-views.sg/2025.04/rib.20250401.0000.bz2,104,20238008,459,1021333,4342,0.4251306870530963,1016991,222774,1251,0.5615556573029168,221523
data/routeviews/route-views.soxrs/2025.04/rib.20250401.0000.bz2,14,1770007,28,969393,64,0.006602069542486897,969329,205887,319,0.15493935994016134,205568
data/routeviews/route-views.sydney/2025.04/rib.20250401.0000.bz2,54,16040176,352,1011792,4075,0.4027507630026725,1007717,219725,998,0.4542041187848447,218727
data/routeviews/route-views.telxatl/2025.04/rib.20250401.0000.bz2,31,7292092,162,1000043,3397,0.3396853935280783,996646,221968,1174,0.5289050673971023,220794
data/routeviews/route-views.uaeix/2025.04/rib.20250401.0000.bz2,36,5213686,111,1014103,2725,0.2687103775454761,1011378,224988,857,0.380909204046438,224131
data/routeviews/route-views.wide/2025.04/rib.20250401.0000.bz2,9,3584762,86,1001250,1863,0.18606741573033708,999387,222597,4540,2.0395602815851066,218057
data/routeviews/route-views2.saopaulo/2025.04/rib.20250401.0000.bz2,76,19572544,437,1021299,3336,0.32664283427282315,1017963,225049,5196,2.3088305213531277,219853
data/routeviews/route-views2/2025.04/rib.20250401.0000.bz2,27,21506586,515,1033770,5097,0.49304971125105196,1028673,0,0,0,0
data/routeviews/route-views3/2025.04/rib.20250401.0000.bz2,42,26909465,619,1024237,5318,0.5192157674444489,1018919,228728,1450,0.6339407505858488,227278
data/routeviews/route-views4/2025.04/rib.20250401.0000.bz2,42,23792944,583,1034190,4888,0.47264042390663225,1029302,232823,1447,0.6215021711772463,231376
data/routeviews/route-views5/2025.04/rib.20250401.0000.bz2,45,24727966,569,1056327,4841,0.45828611784040363,1051486,225625,1359,0.6023268698060942,224266
data/routeviews/route-views6/2025.04/rib.20250401.0000.bz2,27,5273203,109,0,0,0,0,225156,6111,2.7141182113734477,219045
data/routeviews/route-views7/2025.04/rib.20250401.0000.bz2,51,26992427,624,1034436,4168,0.4029248788711916,1030268,231071,1911,0.8270185354285047,229160
data/routeviews/route-views8/2025.04/rib.20250401.0000.bz2,8,4565767,126,1000402,4384,0.4382238340187245,996018,225704,899,0.39830929004359694,224805
